[
{
    "author": "Piknik Color",
    "background": "0x00CDFF",
    "ball": "0xFFAC00",
    "mat": "0x009E1D",
    "bouncer": "0xFFC5BD",
    "obstacle": "0x000000",
    "data":
    [
      [0, 0, 1, 0, 0],
      [0, 0, 1, 0, 0],
      [0, 0, 1, 1, 1],
      [0, 0, 0, 1, 1],
      [0, 0, 0, 0, 1],
      [0, 1, 1, 1, 1],
      [1, 1, 1, 5, 0],
      [10, 10, 4, 0, 0],
      [15, 3, 0, 0, 0],
      [3, 0, 0, 0, 0],
      [0, 0, 0, 0, 0],
      [0, 0, 0, 0, 0],
      [0, 15, 0, 0, 0],
      [0, 1, 0, 0, 0],
      [0, 0, 0, 0, 0],
      [0, 0, 0, 2, 0],
      [0, 0, 15, 3, 0],
      [0, 0, 1, 0, 0],
      [0, 0, 0, 0, 0],
      [0, 0, 0, 0, 0],
      [0, 15, 0, 0, 0],
      [0, 1, 0, 0, 0],
      [0, 5, 5, 5, 0],
      [0, 0, 5, 0, 0],
      [0, 0, 11, 0, 0],
      [0, 0, 1, 0, 0],
      [0, 0, 1, 1, 0],
      [0, 0, 0, 1, 1],
      [0, 0, 0, 1, 1],
      [0, 0, 1, 1, 0],
      [0, 1, 1, 0, 0],
      [1, 1, 0, 0, 0],
      [1, 0, 0, 0, 0],
      [1, 1, 0, 0, 0],
      [0, 1, 1, 0, 0],
      [0, 0, 1, 1, 1],
      [0, 0, 0, 10, 10],
      [0, 0, 0, 0, 15],
      [0, 0, 0, 0, 0],
      [0, 0, 0, 0, 0],
      [0, 0, 0, 0, 0],
      [0, 0, 0, 15, 0],
      [0, 0, 0, 1, 0],
      [0, 0, 0, 0, 0],
      [0, 0, 0, 0, 0],
      [0, 0, 15, 0, 0],
      [0, 0, 1, 0, 0],
      [0, 0, 0, 0, 0],
      [0, 0, 0, 0, 0],
      [0, 15, 0, 0, 0],
      [0, 1, 0, 0, 0],
      [0, 0, 0, 0, 0],
      [0, 0, 0, 0, 0],
      [15, 0, 0, 0, 0],
      [1, 0, 0, 0, 0],
      [0, 0, 0, 0, 0],
      [0, 0, 0, 0, 0],
      [0, 11, 0, 0, 0],
      [0, 1, 0, 0, 0],
      [0, 1, 1, 1, 0],
      [0, 0, 1, 1, 0],
      [0, 0, 4, 1, 0],
      [0, 0, 1, 1, 0],
      [0, 0, 10, 10, 0],
      [0, 0, 1, 8, 0],
      [0, 0, 1, 7, 1],
      [0, 0, 0, 1, 1],
      [0, 4, 0, 0, 1],
      [0, 4, 0, 0, 1],
      [0, 1, 0, 0, 14],
      [0, 1, 0, 0, 1],
      [0, 1, 0, 0, 1],
      [0, 1, 0, 0, 1],
      [0, 11, 0, 0, 4],
      [0, 1, 0, 0, 4],
      [0, 1, 0, 0, 0],
      [0, 1, 1, 0, 0],
      [0, 1, 1, 0, 0],
      [0, 0, 1, 1, 0],
      [0, 0, 1, 1, 0],
      [0, 0, 0, 1, 1],
      [0, 0, 0, 4, 1],
      [0, 0, 0, 1, 1],
      [0, 0, 0, 1, 4],
      [0, 0, 0, 1, 1],
      [0, 0, 0, 4, 1],
      [0, 0, 0, 1, 1],
      [0, 0, 0, 1, 4],
      [0, 0, 0, 1, 1],
      [0, 0, 1, 1, 0],
      [1, 1, 1, 0, 0],
      [4, 1, 0, 0, 0],
      [1, 1, 0, 0, 0],
      [1, 4, 0, 0, 0],
      [1, 1, 0, 0, 0],
      [4, 1, 0, 0, 0],
      [1, 1, 0, 0, 0],
      [1, 4, 0, 0, 0],
      [10, 10, 0, 0, 0],
      [0, 15, 0, 0, 0],
      [0, 0, 0, 0, 0],
      [0, 0, 0, 0, 0],
      [0, 0, 0, 0, 0],
      [0, 0, 15, 0, 0],
      [0, 0, 1, 0, 0],
      [0, 0, 0, 0, 0],
      [0, 0, 0, 0, 15],
      [0, 0, 0, 0, 15],
      [0, 0, 0, 0, 1],
      [0, 0, 0, 0, 1],
      [0, 0, 0, 0, 1],
      [0, 0, 1, 1, 1],
      [0, 0, 1, 1, 4],
      [0, 1, 1, 1, 0],
      [1, 1, 15, 15, 15],
      [1, 1, 0, 0, 0],
      [1, 0, 0, 0, 0],
      [0, 0, 0, 0, 0],
      [0, 0, 0, 1, 0],
      [0, 0, 0, 0, 1],
      [0, 4, 0, 1, 0],
      [0, 4, 0, 0, 1],
      [0, 1, 0, 14, 0],
      [0, 1, 0, 1, 0],
      [0, 1, 0, 1, 0],
      [0, 1, 0, 4, 0],
      [1, 1, 0, 4, 0],
      [11, 4, 0, 0, 0],
      [1, 1, 0, 0, 0],
      [0, 1, 0, 0, 0],
      [0, 1, 0, 0, 0],
      [0, 0, 1, 0, 0],
      [0, 0, 0, 1, 1],
      [0, 0, 0, 0, 1],
      [0, 0, 0, 1, 1],
      [0, 0, 1, 0, 0],
      [0, 1, 0, 0, 0],
      [1, 0, 0, 0, 0],
      [0, 1, 0, 0, 0],
      [0, 0, 1, 0, 0],
      [0, 0, 0, 1, 0],
      [0, 0, 0, 0, 10],
      [15, 0, 0, 0, 15],
      [0, 0, 0, 0, 0],
      [0, 0, 0, 0, 0],
      [0, 0, 0, 0, 0],
      [0, 15, 0, 15, 0],
      [0, 1, 0, 1, 0],
      [0, 0, 0, 0, 0],
      [0, 0, 0, 0, 0],
      [1, 1, 1, 1, 1],
      [1, 1, 1, 1, 1],
      [0, 1, 0, 0, 0],
      [0, 14, 0, 0, 0],
      [0, 1, 0, 0, 1],
      [0, 1, 0, 0, 1],
      [0, 4, 0, 0, 1],
      [0, 4, 0, 0, 1],
      [0, 0, 1, 1, 1],
      [0, 0, 11, 0, 0],
      [0, 0, 1, 0, 0],
      [0, 0, 1, 0, 0],
      [0, 0, 0, 1, 0],
      [0, 0, 0, 0, 8],
      [0, 0, 0, 1, 0],
      [0, 0, 1, 0, 0],
      [0, 1, 0, 0, 0],
      [8, 0, 0, 0, 0],
      [0, 1, 0, 0, 0],
      [0, 0, 1, 0, 0],
      [0, 0, 0, 1, 0],
      [0, 0, 0, 0, 8],
      [0, 0, 0, 1, 0],
      [0, 0, 1, 0, 0],
      [0, 1, 0, 0, 0],
      [8, 0, 0, 0, 0],
      [0, 1, 0, 0, 0],
      [0, 0, 1, 0, 0],
      [0, 1, 0, 1, 0],
      [10, 0, 0, 0, 10],
      [1, 0, 0, 0, 1],
      [1, 0, 0, 0, 1],
      [1, 0, 0, 0, 1],
      [1, 0, 0, 0, 1],
      [1, 0, 0, 0, 1],
      [7, 0, 0, 1, 1],
      [1, 4, 0, 1, 15],
      [1, 4, 1, 0, 0],
      [1, 4, 3, 0, 0],
      [1, 4, 0, 0, 0],
      [1, 4, 0, 0, 0],
      [1, 0, 0, 0, 0],
      [1, 0, 0, 0, 0],
      [1, 1, 1, 0, 0],
      [15, 1, 1, 1, 0],
      [0, 0, 1, 1, 0],
      [0, 0, 0, 1, 1],
      [0, 0, 0, 3, 1],
      [0, 0, 1, 1, 1],
      [1, 1, 1, 1, 0],
      [1, 1, 3, 0, 0],
      [0, 1, 1, 0, 0],
      [0, 1, 3, 0, 0],
      [0, 1, 1, 0, 0],
      [0, 0, 1, 0, 0],
      [3, 1, 1, 1, 3],
      [1, 1, 1, 1, 1],
      [1, 1, 1, 1, 1],
      [0, 1, 1, 1, 0],
      [0, 1, 1, 1, 0],
      [1, 0, 1, 0, 1],
      [1, 0, 1, 0, 1],
      [3, 0, 9, 0, 3]
    ]
  }
]