[
  {
    "author": "True Singularity",
    "background": "0x001109",
    "ball": "0x56947b",
    "mat": "0x003724",
    "bouncer": "0x005ba9",
    "obstacle": "0xdd4290",
    "data":
    [
      [0, 0, 1, 0, 0],
      [0, 1, 0, 1, 0],
      [1, 0, 0, 0, 1],
      [0, 1, 0, 1, 0],
      [0, 0, 1, 0, 0],
      [0, 1, 0, 0, 1],
      [0, 1, 0, 1, 0],
      [0, 0, 0, 0, 1],
      [0, 0, 0, 1, 1],
      [0, 0, 1, 0, 0],
      [0, 1, 1, 0, 0],
      [1, 0, 0, 0, 0],
      [1, 1, 0, 0, 0],
      [0, 0, 1, 1, 0],
      [1, 0, 0, 1, 1],
      [1, 1, 0, 0, 0],
      [0, 1, 1, 0, 1],
      [0, 0, 0, 0, 1],
      [1, 1, 0, 1, 1],
      [1, 0, 0, 0, 0],
      [1, 1, 0, 1, 1],
      [0, 0, 0, 0, 1],
      [1, 1, 0, 1, 1],
      [1, 0, 0, 0, 0],
      [1, 0, 0, 0, 0],
      [1, 1, 0, 1, 1],
      [0, 0, 0, 0, 1],
      [0, 0, 0, 0, 1],
      [1, 1, 0, 1, 1],
      [1, 0, 0, 0, 0],
      [1, 0, 0, 0, 0],
      [1, 1, 0, 1, 0],
      [0, 0, 0, 0, 1],
      [0, 0, 0, 1, 0],
      [0, 0, 1, 0, 0],
      [0, 1, 0, 0, 0],
      [1, 1, 0, 1, 1],
      [0, 0, 0, 1, 0],
      [0, 0, 1, 0, 0],
      [0, 1, 0, 0, 0],
      [1, 0, 0, 0, 0],
      [0, 1, 0, 0, 0],
      [0, 0, 1, 0, 0],
      [0, 0, 0, 1, 0],
      [1, 1, 0, 1, 1],
      [0, 1, 0, 0, 0],
      [0, 0, 1, 0, 0],
      [0, 0, 0, 1, 0],
      [0, 0, 0, 0, 1],
      [0, 0, 0, 1, 0],
      [0, 0, 1, 0, 0],
      [0, 1, 0, 0, 1],
      [1, 0, 0, 1, 0],
      [0, 0, 1, 0, 0],
      [0, 1, 0, 0, 0],
      [1, 0, 0, 0, 0],
      [0, 1, 0, 0, 0],
      [0, 0, 1, 0, 0],
      [0, 0, 0, 1, 0],
      [0, 1, 0, 0, 1],
      [0, 0, 1, 0, 0],
      [0, 0, 0, 1, 0],
      [0, 1, 0, 0, 1],
      [0, 0, 1, 0, 0],
      [0, 1, 0, 0, 1],
      [0, 0, 0, 1, 0],
      [0, 0, 1, 0, 0],
      [0, 1, 0, 0, 0],
      [1, 0, 1, 0, 0],
      [0, 1, 0, 0, 0],
      [0, 0, 1, 0, 0],
      [0, 0, 0, 1, 0],
      [1, 0, 0, 0, 1],
      [0, 1, 0, 0, 0],
      [0, 0, 1, 0, 0],
      [0, 1, 0, 0, 1],
      [1, 0, 0, 1, 0],
      [0, 0, 1, 0, 0],
      [0, 0, 0, 1, 0],
      [0, 0, 0, 0, 1],
      [0, 1, 0, 0, 0],
      [0, 0, 1, 0, 0],
      [0, 0, 1, 0, 0],
      [0, 0, 1, 0, 0],
      [1, 0, 0, 1, 0],
      [1, 1, 0, 0, 0],
      [0, 1, 0, 0, 0],
      [0, 1, 0, 0, 0],
      [1, 1, 0, 0, 1],
      [0, 0, 0, 1, 0],
      [0, 0, 1, 0, 0],
      [0, 0, 0, 1, 0],
      [0, 0, 1, 0, 0],
      [0, 1, 0, 0, 0],
      [1, 0, 0, 0, 0],
      [0, 1, 0, 0, 0],
      [0, 0, 1, 0, 0],
      [0, 0, 0, 1, 0],
      [0, 0, 0, 0, 1],
      [0, 0, 0, 2, 0],
      [0, 0, 0, 0, 0],
      [0, 0, 0, 0, 0],
      [0, 0, 0, 0, 0],
      [1, 0, 0, 0, 0],
      [0, 1, 0, 0, 1],
      [0, 0, 0, 2, 0],
      [0, 0, 0, 0, 0],
      [0, 0, 0, 0, 0],
      [0, 0, 0, 0, 0],
      [0, 0, 0, 0, 1],
      [1, 0, 0, 1, 0],
      [0, 2, 0, 0, 0],
      [0, 0, 0, 0, 0],
      [0, 0, 0, 0, 0],
      [0, 0, 0, 0, 0],
      [1, 0, 0, 0, 0],
      [0, 1, 0, 0, 1],
      [0, 0, 0, 2, 0],
      [0, 0, 0, 0, 0],
      [0, 0, 0, 0, 0],
      [0, 0, 0, 0, 0],
      [0, 2, 0, 1, 0],
      [0, 0, 0, 0, 0],
      [0, 0, 0, 0, 0],
      [0, 0, 0, 0, 0],
      [0, 1, 0, 2, 0],
      [0, 0, 0, 0, 0],
      [0, 0, 0, 0, 0],
      [0, 0, 0, 0, 0],
      [0, 2, 0, 1, 0],
      [0, 0, 0, 0, 0],
      [0, 0, 0, 0, 0],
      [0, 0, 0, 0, 0],
      [0, 1, 0, 2, 0],
      [0, 0, 0, 0, 0],
      [0, 0, 0, 0, 0],
      [0, 0, 0, 0, 0],
      [1, 0, 0, 0, 0],
      [0, 1, 0, 0, 1],
      [0, 0, 0, 1, 0],
      [0, 0, 1, 0, 0],
      [0, 1, 0, 0, 0],
      [1, 0, 0, 0, 1],
      [0, 0, 0, 1, 0],
      [1, 0, 1, 0, 0],
      [1, 0, 0, 0, 0],
      [0, 1, 0, 0, 0],
      [0, 0, 1, 0, 0],
      [0, 0, 0, 1, 0],
      [0, 0, 0, 0, 1],
      [0, 0, 0, 1, 0],
      [0, 0, 1, 0, 0],
      [0, 1, 0, 0, 0],
      [1, 0, 0, 0, 1],
      [0, 0, 0, 1, 0],
      [0, 0, 1, 0, 0],
      [0, 1, 0, 0, 1],
      [0, 0, 0, 1, 0],
      [0, 0, 0, 0, 1],
      [0, 0, 0, 1, 0],
      [0, 0, 1, 0, 0],
      [0, 1, 0, 0, 0],
      [1, 0, 0, 0, 0],
      [0, 1, 0, 0, 0],
      [0, 0, 1, 0, 0],
      [1, 0, 0, 1, 0],
      [0, 1, 0, 0, 0],
      [1, 0, 0, 0, 1],
      [0, 0, 0, 1, 0],
      [0, 0, 1, 0, 0],
      [0, 1, 0, 0, 0],
      [1, 1, 1, 1, 8],
      [0, 1, 0, 0, 0],
      [0, 0, 1, 0, 0],
      [0, 0, 0, 1, 0],
      [1, 0, 0, 0, 1],
      [1, 3, 3, 3, 3],
      [1, 1, 1, 1, 1],
      [3, 3, 3, 3, 1],
      [1, 1, 1, 1, 1],
      [1, 3, 3, 3, 3],
      [1, 1, 1, 1, 1],
      [3, 3, 3, 3, 1],
      [1, 1, 1, 1, 1],
      [1, 3, 3, 3, 3],
      [1, 1, 1, 1, 1],
      [3, 3, 3, 3, 1],
      [1, 1, 1, 1, 1],
      [1, 3, 3, 3, 3],
      [1, 1, 1, 1, 1],
      [3, 3, 3, 3, 1],
      [1, 1, 1, 1, 1],
      [1, 3, 3, 3, 3],
      [1, 1, 1, 1, 1],
      [3, 3, 3, 3, 1],
      [1, 1, 1, 1, 1],
      [1, 3, 3, 3, 3],
      [1, 1, 1, 1, 1],
      [0, 0, 0, 0, 1],
      [1, 0, 0, 0, 1],
      [0, 1, 0, 0, 0],
      [0, 0, 1, 1, 1],
      [0, 0, 0, 0, 1],
      [1, 0, 0, 0, 1],
      [1, 0, 0, 0, 0],
      [1, 1, 1, 0, 1],
      [0, 0, 0, 0, 1],
      [1, 0, 1, 1, 1],
      [1, 0, 0, 0, 0],
      [1, 1, 1, 0, 0],
      [0, 0, 0, 0, 1],
      [0, 0, 0, 1, 0],
      [1, 0, 1, 0, 0],
      [1, 0, 0, 0, 0],
      [0, 1, 0, 0, 0],
      [0, 0, 1, 0, 0],
      [0, 0, 0, 1, 0],
      [0, 0, 0, 0, 1],
      [0, 0, 0, 1, 0],
      [0, 0, 1, 0, 0],
      [0, 0, 2, 0, 0],
      [0, 0, 0, 0, 0],
      [0, 0, 0, 0, 0],
      [0, 0, 0, 0, 0]
    ]
  }
]
