[
  {
    "author": "test5",
    "background": "0xA4E9DC",
    "ball": "0xFFD400",
    "mat": "0x00CEFF",
    "bouncer": "0xD192FF",
    "obstacle": "0xFF4300",
    "data":
    [
      [0, 0, 1, 0, 0],
      [0, 0, 1, 0, 0],
      [3, 0, 1, 0, 3],
      [0, 0, 1, 0, 0],
      [0, 3, 1, 3, 0],
      [4, 0, 1, 0, 4],
      [0, 3, 1, 3, 0],
      [4, 0, 1, 0, 4],
      [0, 3, 1, 3, 0],
      [0, 0, 1, 0, 0],
      [17, 1, 1, 1, 17],
      [0, 1, 1, 1, 0],
      [17, 1, 1, 1, 17],
      [0, 1, 0, 1, 0],
      [17, 1, 0, 1, 17],
      [0, 1, 0, 1, 0],
      [17, 1, 0, 1, 17],
      [0, 1, 0, 1, 0],
      [17, 1, 0, 1, 17],
      [0, 1, 0, 1, 0],
      [17, 1, 0, 1, 17],
      [0, 1, 0, 1, 0],
      [17, 1, 1, 1, 17],
      [0, 0, 1, 0, 0],
      [0, 0, 1, 0, 0],
      [0, 0, 1, 0, 0],
      [0, 0, 1, 0, 0],
      [0, 0, 1, 0, 0],
      [0, 1, 1, 1, 0],
      [0, 1, 1, 1, 0],
      [0, 1, 1, 1, 0],
      [0, 1, 1, 1, 0],
      [1, 1, 1, 1, 1],
      [1, 1, 1, 1, 1],
      [1, 1, 1, 1, 1],
      [1, 1, 1, 1, 1],
      [1, 1, 1, 1, 1],
      [1, 1, 1, 1, 1],
      [1, 1, 1, 1, 1],
      [1, 1, 1, 1, 1],
      [1, 1, 1, 1, 1],
      [0, 1, 1, 1, 0],
      [0, 1, 1, 1, 0],
      [0, 1, 1, 1, 0],
      [0, 1, 1, 1, 0],
      [0, 1, 1, 1, 0],
      [0, 1, 1, 1, 0],
      [0, 1, 1, 1, 0],
      [0, 1, 1, 1, 0],
      [0, 1, 1, 1, 0],
      [0, 1, 1, 1, 0],
      [0, 2, 2, 2, 0],
      [0, 0, 0, 0, 0],
      [0, 0, 0, 0, 0],
      [0, 0, 0, 0, 0],
      [0, 2, 2, 2, 0],
      [0, 0, 0, 0, 0],
      [0, 0, 0, 0, 0],
      [0, 0, 0, 0, 0],
      [0, 2, 0, 2, 0],
      [0, 0, 0, 0, 0],
      [0, 0, 0, 0, 0],
      [0, 0, 0, 0, 0],
      [0, 0, 2, 0, 0],
      [0, 0, 0, 0, 0],
      [0, 0, 0, 0, 0],
      [0, 0, 0, 0, 0],
      [0, 2, 0, 2, 0],
      [0, 0, 0, 0, 0],
      [0, 0, 0, 0, 0],
      [0, 0, 0, 0, 0],
      [4, 1, 1, 1, 4],
      [1, 1, 1, 1, 1],
      [1, 1, 1, 1, 1],
      [1, 1, 1, 1, 1],
      [1, 0, 1, 0, 1],
      [4, 0, 9, 0, 4]
    ]
  }
]
