[
  {
    "author": "test5",
    "background": "0xA4E9DC",
    "ball": "0xFFD400",
    "mat": "0x00CEFF",
    "bouncer": "0xD192FF",
    "obstacle": "0xFF4300",
    "data":
    [
      [0, 0, 1, 0, 0],
      [0, 1, 1, 1, 0],
      [1, 1, 1, 1, 1],
      [0, 116, 1, 116, 0],
      [0, 1, 1, 1, 0],
      [0, 116, 1, 116, 0],
      [0, 1, 1, 1, 0],
      [0, 116, 1, 116, 0],
      [0, 1, 1, 1, 0],
      [0, 2, 1, 2, 0],
      [0, 0, 1, 0, 0],
      [0, 0, 1, 0, 0],
      [2, 0, 1, 0, 2],
      [0, 0, 1, 0, 0],
      [1, 1, 80, 1, 1],
      [0, 0, 1, 0, 0],
      [0, 0, 1, 0, 0],
      [0, 1, 1, 1, 0],
      [1, 1, 0, 1, 1],
      [2, 0, 0, 0, 2],
      [0, 0, 0, 0, 0],
      [0, 0, 0, 0, 0],
      [0, 0, 0, 0, 0],
      [0, 0, 2, 0, 0],
      [0, 0, 0, 0, 0],
      [0, 0, 0, 0, 0],
      [0, 0, 0, 0, 0],
      [0, 10, 0, 10, 0],
      [0, 1, 0, 1, 0],
      [0, 1, 0, 1, 0],
      [0, 1, 0, 1, 0],
      [0, 1, 0, 1, 0],
      [0, 1, 1, 1, 0],
      [0, 1, 1, 1, 0],
      [12, 12, 12, 12, 12],
      [1, 1, 1, 1, 1],
      [1, 1, 1, 1, 116],
      [1, 1, 1, 116, 1],
      [1, 1, 116, 1, 1],
      [1, 1, 1, 1, 1],
      [1, 1, 1, 1, 1],
      [116, 1, 1, 1, 1],
      [1, 116, 1, 1, 1],
      [1, 1, 116, 1, 1],
      [11, 11, 11, 11, 11],
      [0, 2, 2, 2, 0],
      [0, 1, 1, 1, 0],
      [0, 116, 116, 116, 0],
      [0, 1, 1, 1, 0],
      [0, 2, 2, 2, 0],
      [0, 0, 0, 0, 0],
      [0, 0, 0, 0, 0],
      [0, 0, 0, 0, 0],
      [116, 1, 1, 1, 116],
      [1, 1, 1, 1, 1],
      [1, 1, 1, 1, 1],
      [1, 1, 1, 1, 1],
      [0, 1, 1, 1, 0],
      [0, 1, 1, 1, 0],
      [1, 0, 1, 0, 1],
      [1, 0, 1, 0, 1],
      [3, 0, 9, 0, 3]
    ]
  }
]
