[
  {
    "author": "Creator",
    "background": "0xaaaaaa",
    "ball": "0xff1111",
    "mat": "0xffff00",
    "bouncer": "0xff00ff",
    "obstacle": "0x00ddff",
    "data":
    [
      [0, 1, 1, 1, 0],
      [0, 0, 1, 0, 0],
      [0, 0, 2, 0, 0],
      [0, 0, 0, 0, 0],
      [0, 0, 0, 0, 0],
      [0, 1, 0, 0, 0],
      [0, 0, 1, 0, 0],
      [0, 0, 1, 0, 0],
      [0, 0, 1, 0, 0],
      [0, 0, 1, 0, 0],
      [0, 1, 0, 0, 0],
      [1, 0, 0, 0, 0],
      [1, 0, 0, 0, 4],
      [1, 0, 0, 0, 0],
      [2, 2, 0, 0, 0],
      [0, 0, 0, 0, 0],
      [0, 0, 0, 0, 0],
      [0, 0, 0, 0, 0],
      [0, 0, 0, 0, 0],
      [0, 0, 1, 1, 1],
      [0, 0, 1, 0, 1],
      [0, 0, 1, 1, 1],
      [0, 0, 0, 1, 0],
      [0, 0, 0, 1, 0],
      [0, 0, 0, 2, 0],
      [0, 0, 0, 0, 0],
      [1, 1, 0, 0, 0],
      [0, 1, 0, 0, 0],
      [0, 1, 0, 0, 0],
      [0, 1, 1, 0, 0]
    ]
  }
]
