[
  {
    "author": "Maison",
    "background": "0x850100",
    "ball": "0xCE0099",
    "mat": "0xFF4539",
    "bouncer": "0x00C0FF",
    "obstacle": "0x00FFC5",
    "data":
    [
      [1, 1, 1, 1, 1],
      [1, 1, 1, 1, 1],
      [1, 1, 1, 1, 1],
      [2, 2, 2, 2, 2],
      [0, 0, 0, 0, 0],
      [0, 0, 0, 0, 0],
      [1, 1, 0, 1, 1],
      [1, 1, 0, 1, 1],
      [1, 1, 0, 1, 1],
      [1, 1, 0, 1, 1],
      [1, 1, 0, 1, 1],
      [2, 2, 0, 2, 2],
      [0, 0, 0, 0, 0],
      [0, 0, 0, 0, 0],
      [0, 1, 1, 1, 0],
      [0, 1, 1, 1, 0],
      [0, 1, 1, 1, 0],
      [0, 1, 1, 1, 0],
      [0, 1, 1, 1, 0],
      [0, 1, 1, 1, 0],
      [0, 1, 1, 1, 0],
      [0, 2, 2, 2, 0],
      [0, 0, 0, 0, 0],
      [0, 0, 0, 0, 0],
      [0, 0, 0, 0, 0],
      [1, 1, 0, 1, 1],
      [1, 1, 0, 1, 1],
      [1, 1, 0, 1, 1],
      [1, 1, 0, 1, 1],
      [1, 1, 0, 1, 1],
      [2, 2, 0, 2, 2],
      [0, 0, 0, 0, 0],
      [0, 0, 0, 0, 0],
      [0, 1, 0, 1, 0],
      [0, 1, 0, 1, 0],
      [0, 1, 0, 1, 0],
      [0, 2, 0, 2, 0],
      [0, 0, 0, 0, 0],
      [0, 0, 1, 0, 0],
      [0, 0, 1, 0, 0],
      [0, 1, 1, 1, 0],
      [1, 1, 1, 1, 1],
      [1, 1, 1, 1, 1],
      [1, 1, 1, 1, 1],
      [0, 0, 1, 0, 0],
      [0, 1, 1, 1, 0],
      [0, 1, 1, 1, 0],
      [0, 1, 1, 1, 0],
      [0, 1, 1, 1, 0],
      [0, 1, 1, 1, 0],
      [0, 0, 1, 0, 0],
      [0, 1, 1, 1, 0],
      [0, 1, 0, 1, 0],
      [0, 1, 0, 1, 0],
      [0, 1, 1, 1, 0],
      [0, 1, 1, 1, 0],
      [0, 1, 1, 1, 0],
      [1, 1, 1, 1, 1],
      [1, 0, 0, 0, 1],
      [1, 1, 0, 1, 1],
      [1, 1, 1, 1, 1],
      [2, 2, 2, 2, 2]
    ]
  }
]