[
  {
    "author": "Micro Emotion",
    "background": "0x89005E",
    "ball": "0xDE2100",
    "mat": "0xFF00B6",
    "bouncer": "0x00B478",
    "obstacle": "0x340DC8",
    "data":
    [
      [0, 0, 1, 0, 0],
      [0, 0, 2, 0, 0],
      [0, 0, 0, 0, 0],
      [0, 0, 3, 0, 0],
      [0, 0, 0, 0, 0],
      [0, 1, 0, 1, 0],
      [2, 0, 0, 0, 2],
      [0, 0, 0, 0, 0],
      [3, 0, 0, 0, 3],
      [0, 0, 0, 0, 0],
      [1, 0, 0, 0, 1],
      [0, 2, 0, 2, 0],
      [0, 0, 0, 0, 0],
      [0, 0, 3, 0, 0],
      [0, 0, 0, 0, 0],
      [0, 1, 0, 1, 0],
      [0, 0, 2, 0, 0],
      [0, 0, 0, 0, 0],
      [3, 0, 0, 0, 3],
      [0, 0, 0, 0, 0],
      [0, 0, 1, 0, 0],
      [0, 2, 0, 2, 0],
      [0, 0, 0, 0, 0],
      [0, 0, 3, 0, 0],
      [0, 0, 0, 0, 0],
      [0, 1, 0, 1, 0],
      [2, 0, 0, 0, 2],
      [0, 0, 0, 0, 0],
      [3, 0, 0, 0, 3],
      [0, 0, 0, 0, 0],
      [1, 0, 0, 0, 1],
      [0, 1, 0, 1, 0],
      [0, 0, 1, 0, 0],
      [0, 1, 0, 1, 0],
      [1, 0, 4, 0, 1],
      [0, 1, 0, 1, 0],
      [0, 0, 1, 0, 0],
      [0, 0, 0, 1, 0],
      [0, 0, 1, 0, 0],
      [0, 1, 0, 1, 0],
      [1, 0, 4, 0, 1],
      [0, 1, 0, 1, 0],
      [0, 0, 1, 0, 0],
      [0, 0, 0, 1, 0],
      [0, 0, 1, 0, 0],
      [0, 1, 0, 1, 0],
      [1, 0, 4, 0, 1],
      [0, 1, 0, 1, 0],
      [0, 0, 1, 0, 0],
      [0, 1, 0, 0, 0],
      [0, 0, 1, 0, 0],
      [0, 1, 0, 1, 0],
      [1, 0, 4, 0, 1],
      [0, 1, 0, 1, 0],
      [0, 0, 1, 0, 0],
      [0, 1, 0, 1, 0],
      [1, 0, 4, 0, 1],
      [0, 1, 0, 1, 0],
      [0, 0, 1, 0, 0],
      [0, 0, 0, 1, 0],
      [0, 0, 1, 0, 0],
      [0, 1, 0, 1, 0],
      [1, 0, 4, 0, 1],
      [0, 1, 0, 1, 0],
      [0, 0, 1, 0, 0],
      [0, 0, 2, 0, 0],
      [0, 0, 0, 0, 0],
      [0, 0, 0, 0, 0],
      [0, 0, 0, 0, 0],
      [0, 0, 1, 0, 0],
      [0, 0, 1, 0, 0],
      [0, 1, 0, 1, 0],
      [1, 0, 4, 0, 1],
      [0, 1, 0, 1, 0],
      [0, 0, 1, 0, 0],
      [0, 1, 0, 1, 0],
      [1, 0, 0, 0, 1],
      [1, 0, 0, 0, 1],
      [1, 0, 0, 0, 1],
      [1, 0, 0, 0, 1],
      [1, 0, 0, 0, 1],
      [0, 1, 0, 1, 0],
      [1, 0, 0, 0, 1],
      [1, 0, 0, 0, 1],
      [0, 1, 0, 1, 0],
      [1, 1, 0, 1, 1],
      [1, 0, 0, 0, 1],
      [0, 1, 1, 1, 0],
      [0, 0, 1, 0, 0],
      [0, 1, 0, 1, 0],
      [0, 1, 0, 1, 0],
      [0, 1, 0, 1, 0],
      [0, 1, 0, 1, 0],
      [0, 0, 1, 0, 0],
      [0, 1, 0, 0, 0],
      [1, 0, 0, 0, 0],
      [0, 1, 0, 0, 0],
      [0, 0, 1, 0, 0],
      [0, 0, 0, 1, 0],
      [0, 0, 0, 0, 1],
      [0, 0, 0, 1, 0],
      [0, 0, 1, 0, 0],
      [0, 1, 0, 0, 0],
      [1, 0, 0, 0, 0],
      [0, 1, 0, 0, 0],
      [0, 0, 1, 0, 0],
      [0, 0, 0, 1, 0],
      [0, 0, 0, 0, 1],
      [0, 0, 0, 1, 0],
      [0, 0, 1, 0, 0],
      [0, 19, 0, 0, 0],
      [0, 0, 19, 0, 0],
      [0, 0, 0, 19, 0],
      [0, 0, 19, 0, 0],
      [0, 19, 0, 0, 0],
      [19, 0, 19, 0, 0],
      [0, 19, 0, 19, 0],
      [0, 0, 19, 0, 19],
      [0, 0, 0, 19, 0],
      [0, 0, 19, 0, 19],
      [0, 0, 19, 0, 19],
      [0, 0, 0, 19, 0],
      [0, 0, 19, 0, 19],
      [0, 19, 0, 19, 0],
      [19, 0, 19, 0, 0],
      [0, 19, 0, 0, 0],
      [19, 0, 0, 0, 0],
      [0, 19, 0, 0, 0],
      [19, 0, 19, 0, 0],
      [0, 19, 0, 19, 0],
      [0, 0, 19, 0, 19],
      [0, 0, 0, 19, 0],
      [0, 0, 19, 0, 0],
      [0, 0, 1, 0, 0],
      [0, 1, 0, 1, 0],
      [0, 1, 0, 1, 0],
      [0, 1, 0, 1, 0],
      [0, 1, 0, 1, 0],
      [0, 0, 1, 0, 0],
      [0, 2, 2, 2, 0]
    ]
  },
  {
    "author": "Fell Gate",
    "background": "0x670010",
    "ball": "0xFF6400",
    "mat": "0xD11900",
    "bouncer": "0x000000",
    "obstacle": "0x581900",
    "data":
    [
      [0, 1, 1, 1, 0],
      [0, 2, 2, 2, 0],
      [0, 0, 0, 0, 0],
      [0, 0, 0, 0, 0],
      [0, 0, 0, 0, 0],
      [2, 0, 0, 0, 2],
      [0, 0, 0, 0, 0],
      [3, 0, 0, 0, 3],
      [0, 3, 0, 3, 0],
      [19, 0, 3, 0, 19],
      [0, 19, 0, 19, 0],
      [0, 19, 19, 19, 0],
      [0, 19, 19, 19, 0],
      [3, 0, 19, 0, 3],
      [0, 19, 0, 19, 0],
      [19, 0, 0, 0, 19],
      [0, 19, 0, 19, 0],
      [0, 0, 19, 0, 3],
      [3, 0, 1, 3, 0],
      [0, 3, 1, 0, 0],
      [3, 0, 1, 0, 3],
      [0, 1, 0, 3, 0],
      [1, 0, 3, 0, 0],
      [0, 1, 0, 3, 0],
      [3, 0, 1, 0, 3],
      [0, 3, 0, 1, 0],
      [0, 0, 3, 0, 1],
      [0, 0, 0, 1, 0],
      [0, 0, 1, 0, 0],
      [0, 0, 1, 0, 0]
    ]
  }
]