[
  {
    "author": "data1",
    "background": "0xB6FCFF",
    "ball": "0xFF1B00",
    "mat": "0xFFC200",
    "bouncer": "0xFF7500",
    "obstacle": "0x818181",
    "data":
    [
      [1, 1, 1, 1, 1],
      [0, 1, 1, 1, 0],
      [0, 0, 1, 0, 0],
      [0, 0, 1, 0, 0],
      [0, 1, 1, 1, 0],
      [0, 1, 1, 1, 0],
      [0, 1, 1, 1, 0],
      [0, 0, 1, 0, 0],
      [0, 0, 1, 0, 0],
      [0, 1, 1, 1, 0],
      [0, 2, 2, 2, 0],
      [0, 0, 0, 0, 0],
      [0, 0, 0, 0, 0],
      [0, 0, 0, 0, 0],
      [0, 0, 1, 0, 0],
      [0, 0, 1, 0, 0],
      [0, 1, 1, 1, 0],
      [0, 1, 1, 1, 0],
      [1, 1, 1, 1, 1],
      [0, 1, 1, 1, 0],
      [0, 2, 2, 2, 0],
      [0, 0, 0, 0, 0],
      [0, 0, 0, 0, 0],
      [0, 0, 0, 0, 0],
      [1, 0, 0, 0, 1],
      [1, 0, 0, 0, 1],
      [1, 1, 0, 1, 1],
      [2, 2, 0, 2, 2],
      [0, 0, 0, 0, 0],
      [0, 0, 0, 0, 0],
      [0, 0, 0, 0, 0],
      [0, 2, 2, 2, 0],
      [0, 1, 1, 1, 0],
      [0, 1, 1, 1, 0],
      [0, 1, 1, 1, 0],
      [0, 2, 2, 2, 0],
      [0, 1, 1, 1, 0],
      [0, 1, 1, 1, 0],
      [0, 1, 1, 1, 0],
      [0, 2, 2, 2, 0],
      [0, 0, 0, 0, 0],
      [0, 0, 0, 0, 0],
      [0, 0, 0, 0, 0],
      [0, 0, 0, 2, 0],
      [0, 0, 0, 1, 0],
      [0, 0, 0, 1, 0],
      [0, 0, 0, 1, 0],
      [0, 2, 0, 0, 0],
      [0, 1, 0, 0, 0],
      [0, 1, 0, 0, 0],
      [0, 1, 0, 0, 0],
      [0, 0, 0, 2, 0],
      [0, 0, 0, 1, 0],
      [0, 0, 0, 1, 0],
      [0, 0, 0, 1, 0],
      [0, 2, 0, 0, 0],
      [0, 1, 0, 0, 0],
      [0, 1, 0, 0, 0],
      [0, 1, 0, 0, 0],
      [0, 1, 1, 1, 0],
      [1, 1, 1, 1, 1],
      [1, 1, 1, 1, 1],
      [0, 1, 1, 1, 0],
      [0, 0, 1, 0, 0],
      [0, 0, 1, 0, 0],
      [0, 1, 1, 1, 0],
      [0, 1, 1, 1, 0],
      [0, 1, 1, 1, 0],
      [1, 1, 1, 1, 1],
      [0, 1, 1, 1, 0],
      [0, 0, 1, 0, 0],
      [0, 2, 2, 2, 0],
      [0, 0, 0, 0, 0],
      [0, 0, 0, 0, 0],
      [0, 0, 0, 0, 0],
      [2, 2, 0, 0, 0],
      [1, 1, 0, 0, 0],
      [1, 1, 0, 0, 0],
      [1, 1, 0, 0, 0],
      [2, 2, 0, 0, 0],
      [1, 1, 0, 0, 0],
      [1, 1, 0, 0, 0],
      [1, 1, 0, 0, 0],
      [2, 2, 0, 0, 0],
      [0, 0, 0, 0, 0],
      [0, 0, 0, 0, 0],
      [0, 0, 0, 0, 0],
      [0, 0, 0, 2, 2],
      [0, 0, 0, 1, 1],
      [0, 0, 0, 1, 1],
      [0, 0, 0, 1, 1],
      [0, 0, 0, 2, 2],
      [0, 0, 0, 1, 1],
      [0, 0, 0, 1, 1],
      [0, 0, 0, 1, 1],
      [0, 0, 0, 2, 2],
      [0, 0, 0, 0, 0],
      [0, 0, 0, 0, 0],
      [0, 0, 0, 0, 0],
      [0, 2, 2, 2, 0],
      [0, 1, 1, 1, 0],
      [0, 1, 1, 1, 0],
      [0, 1, 1, 1, 0],
      [0, 2, 2, 2, 0],
      [0, 0, 0, 0, 0],
      [1, 1, 0, 0, 0],
      [1, 1, 1, 0, 0],
      [1, 1, 1, 1, 0],
      [1, 1, 1, 1, 1],
      [1, 1, 1, 1, 1],
      [1, 1, 1, 3, 3],
      [1, 1, 1, 1, 1],
      [0, 1, 1, 1, 1],
      [0, 0, 1, 1, 1],
      [0, 0, 0, 1, 1],
      [3, 3, 3, 1, 1],
      [1, 1, 1, 1, 1],
      [1, 1, 1, 1, 1],
      [1, 1, 1, 1, 0],
      [1, 1, 1, 0, 0],
      [1, 1, 1, 3, 3],
      [1, 1, 1, 1, 1],
      [0, 1, 1, 1, 1],
      [0, 0, 1, 1, 1],
      [0, 0, 0, 1, 1],
      [3, 3, 3, 1, 1],
      [0, 0, 0, 1, 1],
      [0, 0, 1, 1, 1],
      [0, 0, 1, 1, 1],
      [0, 0, 2, 2, 2],
      [0, 0, 0, 0, 0],
      [0, 0, 0, 0, 0],
      [0, 0, 0, 0, 0],
      [0, 2, 2, 2, 0],
      [0, 1, 1, 1, 0],
      [0, 1, 1, 1, 0],
      [0, 1, 1, 1, 0],
      [0, 2, 2, 2, 0],
      [0, 0, 0, 0, 0],
      [0, 0, 0, 0, 0],
      [0, 0, 0, 0, 0]
    ]
  }
]